******
SE**3*
*----*
*-**-*
*4**5*
******
******
**5*4*
*----*
*-**-*
*-3--*
******
******
*4**1*
*----*
*-**-*
*-2--*
******
******
*3**2*
*----*
**-*-*
*1---*
******
******
**2--*
*-**-E
*-****
*---1*
******